####################
#  ### # ### # #####
#      #  o  #  o  #
#   #  o  #  o  #  #
### # ### # ### #  #
#   #  o  #  o  #  #
##     #  o  #     #
## ### # ### # ###f#
##  o  #  o  #  o  #
#   #  o  #  o  #  #
### # ### # ### #  #
#   #     #     #  #
#s  o  #  o  #  o  #
## ### # ### # #####
####################
