####################
##   ###   ###   ###
#  #  #  #  #  #  ##
# ### o ### o ###  #
#  #  #  #  #  #  ##
## o ### o ### o ###
#  #  #  #  #  #  ##
# ### oo###oo ###of#
#  #  #  #  #  #  ##
## o ### o ### o ###
#  #  #  #  #  #  ##
# ### o ### o ###  #
#s #  #  #  #  #  ##
##   ###   ###   ###
####################
